1111111111111111111111111111111111111111111111111
1000000000000000000000000000000000000000000000001
1222222222222222222222222222222222222222222222221
1011010101101011010101101011010101101011010101101
1211212121121211212121121211212121121211212121121
1010010100101010010100101010010100101010010100101
1212212122121212212122121212212122121212212122121
1000110110001000110110001000110110001000110110001
1222112112221222112112221222112112221222112112221
1010000000101010000000100010000000101010000000101
1212222222121212222222122212222222121212222222121
1010110110100010110110101010110110100010110110101
1212112112122212112112121212112112122212112112121
1010000000101010000000101010000000101010000000101
1212222222121212222222121212222222121212222222121
1000110110001000110110001000110110001000110110001
1222112112221222112112221222112112221222112112221
1010010100101010010100100010010100101010010100101
1212212122121212212122122212212122121212212122121
1011010101101011010101101011010101101011010101101
1211212121121211212121121211212121121211212121121
1000000000000000000000001000000000000000000000001
1222222222222222222222221222222222222222222222221
1011110111104011110111101011110111104011110111101
1211112111124211112111121211112111124211112111121
1000000000000000000000000000000000000000000000001
1222222222222222222222222222222222222222222222221
1011010101101011010101101011010101101011010101101
1211212121121211212121121211212121121211212121121
1010010100101010010100101010010100101010010100101
1212212122121212212122121212212122121212212122121
1000110110001000110110001000110110001000110110001
1222112112221222112112221222112112221222112112221
1010000000101010000000100010000000101010000000101
1212222222121212222222122212222222121212222222121
1010110110100010110110101010110110100010110110101
1212112112122212112112121212112112122212112112121
1010000000101010000000101010000000101010000000101
1212222222121212222222121212222222121212222222121
1000110110001000110110001000110110001000110110001
1222112112221222112112221222112112221222112112221
1010010100101010010100100010010100101010010100101
1212212122121212212122122212212122121212212122121
1011010101101011010101101011010101101011010101101
1211212121121211212121121211212121121211212121121
1000000000000000000000000000000000000000000000001
1222222222222222222222222222222222222222222222221
1011101110111011101110003000111011101110111011101
1211121112111211121112223222111211121112111211121
1000000000000000000000000000000000000000000000001
1222222222222222222222222222222222222222222222221
1011010101101011010101101011010101101011010101101
1211212121121211212121121211212121121211212121121
1010010100101010010100100010010100101010010100101
1212212122121212212122122212212122121212212122121
1000110110001000110110001000110110001000110110001
1222112112221222112112221222112112221222112112221
1010000000101010000000101010000000101010000000101
1212222222121212222222121212222222121212222222121
1010110110100010110110101010110110100010110110101
1212112112122212112112121212112112122212112112121
1010000000101010000000100010000000101010000000101
1212222222121212222222122212222222121212222222121
1000110110001000110110001000110110001000110110001
1222112112221222112112221222112112221222112112221
1010010100101010010100101010010100101010010100101
1212212122121212212122121212212122121212212122121
1011010101101011010101101011010101101011010101101
1211212121121211212121121211212121121211212121121
1000000000000000000000000000000000000000000000001
1222222222222222222222222222222222222222222222221
1011110111104011110111101011110111104011110111101
1211112111124211112111121211112111124211112111121
1000000000000000000000001000000000000000000000001
1222222222222222222222221222222222222222222222221
1011010101101011010101101011010101101011010101101
1211212121121211212121121211212121121211212121121
1010010100101010010100100010010100101010010100101
1212212122121212212122122212212122121212212122121
1000110110001000110110001000110110001000110110001
1222112112221222112112221222112112221222112112221
1010000000101010000000101010000000101010000000101
1212222222121212222222121212222222121212222222121
1010110110100010110110101010110110100010110110101
1212112112122212112112121212112112122212112112121
1010000000101010000000100010000000101010000000101
1212222222121212222222122212222222121212222222121
1000110110001000110110001000110110001000110110001
1222112112221222112112221222112112221222112112221
1010010100101010010100101010010100101010010100101
1212212122121212212122121212212122121212212122121
1011010101101011010101101011010101101011010101101
1211212121121211212121121211212121121211212121121
1000000000000000000000000000000000000000000000001
1222222222222222222222222222222222222222222222221
1111111111111111111111111111111111111111111111111
1111111111111111111111111111111111111111111111111