1111111111111111112111111111111111111
1000000000000000000000000000000000001
1222222222222222222222222222222222221
1010111011101110101010111011101110101
1212111211121112121212111211121112121
1010001000001000101010001000001000101
1212221222221222121212221222221222121
1010101110111010101010101110111010101
1212121112111212121212121112111212121
1010101000001010101010101000001010101
1212121222221212121212121222221212121
1000101011101010001000101011101010001
1222121211121212221222121211121212221
1010101000001010101010101000001010101
1212121222221212121212121222221212121
1010101100011010101010101100011010101
1212121122211212121212121122211212121
1011100004000011100011100004000011101
1211122224222211122211122224222211121
1010101100011010101010101100011010101
1212121122211212121212121122211212121
1010101000001010101010101000001010101
1212121222221212121212121222221212121
1000101011101010001000101011101010001
1222121211121212221222121211121212221
1010101000001010101010101000001010101
1212121222221212121212121222221212121
1010101110111010101010101110111010101
1212121112111212121212121112111212121
1010001000001000101010001000001000101
1212221222221222121212221222221222121
1010111011101110101010111011101110101
1212111211121112121212111211121112121
1000000000000100000000010000000000001
1222222222222122222222212222222222221
0010111100011111103011111100011110100
2212111122211111123211111122211112122
1000000000000000000000000000000000001
1222222222222222222222222222222222221
1010111011101110101010111011101110101
1212111211121112121212111211121112121
1010001000001000101010001000001000101
1212221222221222121212221222221222121
1010101110111010101010101110111010101
1212121112111212121212121112111212121
1010101000001010101010101000001010101
1212121222221212121212121222221212121
1000101011101010001000101011101010001
1222121211121212221222121211121212221
1010101000001010101010101000001010101
1212121222221212121212121222221212121
1010101100011010101010101100011010101
1212121122211212121212121122211212121
1011100004000011100011100004000011101
1211122224222211122211122224222211121
1010101100011010101010101100011010101
1212121122211212121212121122211212121
1010101000001010101010101000001010101
1212121222221212121212121222221212121
1000101011101010001000101011101010001
1222121211121212221222121211121212221
1010101000001010101010101000001010101
1212121222221212121212121222221212121
1010101110111010101010101110111010101
1212121112111212121212121112111212121
1010001000001000101010001000001000101
1212221222221222121212221222221222121
1010111011101110101010111011101110101
1212111211121112121212111211121112121
1000000000000000000000000000000000001
1222222222222222222222222222222222221
1111111111111111110111111111111111111
1111111111111111112111111111111111111