1111111111111111111111111111111111111
1000000000000000000000000000000000001
1010111011101110101010111011101110101
1010001000001000101010001000001000101
1010101110111010101010101110111010101
1010101000001010101010101000001010101
1000101011101010001000101011101010001
1010101000001010101010101000001010101
1010101100011010101010101100011010101
1011100004000011100011100004000011101
1010101100011010101010101100011010101
1010101000001010101010101000001010101
1000101011101010001000101011101010001
1010101000001010101010101000001010101
1010101110111010101010101110111010101
1010001000001000101010001000001000101
1010111011101110101010111011101110101
1000000000000100000000010000000000001
1010111100011111103011111100011110101
1000000000000000000000000000000000001
1010111011101110101010111011101110101
1010001000001000101010001000001000101
1010101110111010101010101110111010101
1010101000001010101010101000001010101
1000101011101010001000101011101010001
1010101000001010101010101000001010101
1010101100011010101010101100011010101
1011100004000011100011100004000011101
1010101100011010101010101100011010101
1010101000001010101010101000001010101
1000101011101010001000101011101010001
1010101000001010101010101000001010101
1010101110111010101010101110111010101
1010001000001000101010001000001000101
1010111011101110101010111011101110101
1000000000000000000000000000000000001
1111111111111111111111111111111111111